####################
# B  ###############
#    ###############
#    ###############
#  #################
##        ##########
###### #############
###### #############
######              
####################