##########
# B  #####
#    #####
#    #####
##########
##########
##########
##########
##########
##########