####################
# B  ###############
#    ###############
#    ###############
####################
####################
####################
####################
####################
####################